11111111111
11111400001
11111001101
11100001101
11111001101
11120000001
11101001101
11121221101
11100001001
11101031001
11100001111
11111111111
