11111111111
11100400001
11101001101
11100001101
11101001101
11120000001
11101301101
11021221101
11000001001
11101031001
11100031111
11111111111
